#######################################################################################################################################################
#A       #  #     #        #     #     #     #  #  #     #  #  #     #     #  #  #  #              #  #  #  #  #     #  #           #  #     #        #
####  ####  #  ####  ####  #  #######  #  #  #  #  #  #  #  #  #  ##########  #  #  #  #######  #  #######  #  ####  #  ##########  #  #######  ####  #
#  #  #  #     #     #  #  #  #  #  #     #  #  #     #  #        #     #     #  #        #  #  #        #     #              #        #     #  #  #  #
#  #  #  ####  #######  #  #  #  #  #######  #############  #######  #  #  #######  ####  #  #  #######  #  #  #  ####  #  ####  #  #  ####  ####  #  #
#  #  #  #  #        #  #        #        #  #  #  #  #  #           #  #  #     #     #     #  #     #     #  #  #  #  #     #  #  #     #  #  #  #  #
#  #  #  #  #######  #  #  ####  ####  #  ####  #  #  #  #  ##########  #  #  #  #######  ####  ####  #  ##########  #######  #  ####  ####  #  #  #  #
#  #  #  #           #  #  #           #     #                 #     #     #  #  #  #  #  #     #        #     #  #        #     #                 #  #
#  #  #  #  ##########  #  #######  ####  #  #######  ####  #  #  ####  #  #  #  #  #  #############  #######  #  #######  #  #############  #  ####  #
#  #     #  #  #     #     #        #  #  #     #  #  #     #  #  #  #  #     #     #           #  #  #  #     #           #        #        #  #     #
#  ####  #  #  #  ####  #  ####  ####  #######  #  #  ##########  #  #  #  #######  ####  ####  #  ####  #  #######  #  ####  ####  ####  ####  ####  #
#  #     #  #           #  #  #     #           #     #     #  #        #  #     #     #  #     #        #        #  #        #  #  #  #  #  #        #
#  #  #  #  #  ##########  #  ####  #  #######  #######  #  #  ####  #  ####  #  #  #  #  #  #  #######  ####  ##########  #  #  ####  ####  #  ####  #
#     #        #  #     #  #        #     #     #        #  #        #  #  #  #     #     #  #     #  #              #  #  #  #     #     #     #  #  #
##########  #  #  ####  #######  ##########  #######  #  #  #######  #  #  #  #######  ####  ####  #  #  #######  #  #  ##########  #  ####  ####  ####
#  #  #     #  #  #           #     #  #        #  #  #  #           #  #     #  #     #     #     #           #  #  #  #              #  #  #  #  #  #
#  #  #  ####  #  #  #  ####  #######  #  #  #  #  #  #############  #  #  ####  #  #  #######  ####  #  ####  ####  #  #######  #######  #  #  #  #  #
#           #  #     #  #     #  #  #     #  #     #     #     #     #  #     #     #     #     #  #  #  #  #     #     #     #        #           #  #
#######  #  #######  #  #######  #  ##########  ####  #######  ####  #######  #######  ####  ####  #######  #  #  ##########  ####  #######  #  ####  #
#  #  #  #           #  #        #     #     #        #           #  #  #     #        #  #  #           #     #     #  #                    #     #  #
#  #  #  #  ################  ####  ####  #  ##########  #######  #  #  #  #######  #  #  #  #  #######  #######  ####  #  ##########  ####  #######  #
#  #  #  #     #        #     #        #  #     #           #  #  #  #     #        #  #  #  #  #  #           #           #     #     #  #     #     #
#  #  #  ##########  #  #  ####  #############  ####  ####  #  #############  ####  ####  #  #  #  ####  #  #  #############  #  #  ####  #######  ####
#     #  #           #     #     #        #           #     #        #     #  #  #  #           #     #  #  #     #  #  #     #           #     #     #
#  ####  #  #  ####  ##########  ####  #######  #######  ####  ####  ####  #  #  ###################  #  ####  ####  #  ####  ####  ####  #  ####  #  #
#  #        #  #     #     #              #     #  #           #  #                 #              #  #  #              #     #     #        #     #  #
#  ################  ####  #  ##########  #  ####  #############  ###################  ####  #######  ####  ##########  #######  #  #  #  #  #  #  ####
#     #        #        #        #  #     #     #        #        #              #  #     #     #     #  #     #  #     #     #  #  #  #  #     #     #
####  #  #  #  ####  #  ####  ####  ##########  #  #  ####  #######  #############  #######  #  #  #  #  #  #  #  ####  #  #  ##########  ####  ####  #
#  #  #  #  #  #     #     #           #           #     #     #  #     #              #     #  #  #        #  #  #  #     #                 #  #  #  #
#  #  #######  #  ##########  #  #  #  #  ##########  #######  #  ####  ####  #  #######  ####  ##########  ####  #  #  ####  ####  #  ##########  #  #
#  #  #                    #  #  #  #           #     #           #  #     #  #              #  #     #     #     #        #     #  #     #     #  #  #
#  #  #######  ####  #############  #######  #  #  #  #  ##########  #  #  #  #  ####  #  #######  #  ####  #  ################  #######  #  ####  #  #
#                 #  #     #     #  #        #  #  #  #     #     #  #  #     #  #  #  #  #  #     #  #        #  #        #     #  #  #  #     #     #
####  ##########  #  ####  #  #  ####  ################  #  ####  #  #############  ####  #  #  #  ####  #######  #  ####  ####  #  #  #  #  #######  #
#  #  #  #  #  #  #  #  #     #           #  #  #     #  #        #              #     #        #  #     #              #        #     #  #  #     #  #
#  #  #  #  #  #######  #  ##########  ####  #  #  #  #  #######  #  ####  #  #  ####  #  ####  #######  ####  #############  #######  #  #  ####  #  #
#           #        #  #        #  #     #  #     #  #        #     #     #  #     #        #     #  #  #        #  #        #  #     #  #  #  #     #
#  #############  #  #  #  #######  ####  #  #######  #######  #######  #  ##########  #  #######  #  #######  ####  ####  ####  #  #  ####  #  ####  #
#  #  #     #     #  #     #     #  #  #     #     #     #  #  #        #  #     #     #  #  #     #        #     #  #     #        #     #  #        #
#  #  #  #######  #######  #  ####  #  #######  #  ####  #  ##########  #######  #  #######  ####  ####  #######  #  #############  ####  #  #######  #
#  #  #     #  #  #     #  #        #  #        #                                   #     #     #        #  #  #        #        #  #     #     #  #  #
####  ####  #  #  #  ####  ####  ####  #  #  #############  #######  #  ####  #  ####  ####  #  #  ####  #  #  ####  ####  #  ####  ####  #  #  #  ####
#        #  #     #  #           #     #  #  #     #     #     #  #  #     #  #     #        #     #              #  #  #  #     #     #     #  #     #
####  ####  ####  #  #  #  ####  #  ####  #######  ####  ####  #  #  ####  ################  #  ###################  #  #  #######  ################  #
#  #     #     #  #  #  #     #  #     #        #           #  #  #     #  #     #     #  #  #  #     #        #     #        #              #  #  #  #
#  #  ####  #  #  #  #  #  ##########  #######  ##########  #  #  #  #  ####  ####  #  #  ####  #  #  #  #  #######  #  #  ####  #############  #  #  #
#  #  #     #     #     #  #     #        #     #        #  #  #     #  #     #     #              #  #  #  #        #  #                 #  #        #
#  #  #  #  #  ##########  ####  #  ####  #  ##########  #  #  ####  #  #  ####  ####  ####  #  #  #######  ####  #  #  #  ##########  ####  ####  ####
#        #  #  #        #  #     #  #     #     #  #  #        #  #  #  #  #     #  #  #     #  #     #     #     #  #  #     #  #                    #
####  ####  #  #  #######  ####  #######  #  ####  #  #  #  ####  #  #  #  ####  #  ###################  ##########  #  #######  ################  #  #
#  #  #  #  #  #  #        #  #     #  #     #     #  #  #     #     #  #  #     #                 #     #        #     #        #  #  #     #     #  #
#  ####  ####  #  ####  #  #  ####  #  ##########  #  ####  #######  ####  #  ##########  ##########  #######  #######  #  #  ####  #  #  #  ##########
#     #  #  #  #  #     #  #  #     #        #     #  #     #     #  #  #                             #     #        #     #        #  #  #        #  #
####  #  #  #  #  #  #######  ####  #  #  ####  #  #  #  ####  #######  ####  ####  #  #############  ####  #  ####  #######  #  #  #  #  ####  ####  #
#     #           #  #        #        #  #  #  #  #                       #  #     #  #  #  #        #  #     #        #     #  #  #  #  #     #     #
####  #  ####  ##########  ####  ####  ####  #  #############  ##########  #############  #  #######  #  #######  ####  #  ##########  ####  #######  #
#  #     #     #           #     #  #        #              #     #  #     #     #           #                 #  #  #     #           #  #  #     #  #
#  #######  ##########  ####  #  #  #  ################  ####  ####  #######  #  #  #  #  #######  ####  #  #  #  #  #######  #######  #  #  #  ####  #
#  #           #     #  #     #     #  #     #                    #  #        #  #  #  #     #     #     #  #  #     #  #     #     #        #  #     #
#  #  #######  #  #  #  #############  #  #  #######  #############  ##########  #  #######  ####  ##########  ####  #  ####  #  #############  #  ####
#        #     #  #  #  #  #     #     #  #  #     #  #  #           #  #     #        #  #     #     #  #        #  #        #     #  #     #     #  #
##########  ####  ####  #  #  ####  #  ####  ####  ####  #  ##########  ####  ##########  ####  #  ####  ##########  #  #######  ####  ####  #  #  #  #
#  #        #  #     #  #     #  #  #  #        #                    #  #  #     #        #     #     #                    #        #     #     #     #
#  #######  #  #  #  #  #  #  #  #  #  ####  #  #  #######  ####  #  #  #  ####  #  ####  ####  #  #############  #  #  ####  #  ####  #############  #
#                 #     #  #     #  #        #           #  #  #  #  #                 #  #        #              #  #  #     #     #        #  #     #
#######  #  #  #######  #  ####  ################  ##########  #  #######  ##########  ####  #  ################  #  #  ##########  ####  ####  #  ####
#     #  #  #        #     #                    #     #  #  #        #              #        #     #     #        #  #        #  #                    #
####  ####  #  #######  #######  ##########  #  #  #  #  #  ####  ##########  #######  ####  #######  ##########  ####  #######  ####  #######  #######
#  #        #  #  #     #  #  #  #           #  #  #     #              #  #     #  #     #  #        #     #        #     #        #     #        #  #
#  #  ##########  #  ####  #  #  ####  #######  #  ####  #  #######  ####  #######  #  #  #######  #######  #  #  #######  #  #  #  #  ####  #######  #
#     #  #     #        #           #  #              #  #  #  #           #     #     #  #     #  #           #        #  #  #  #  #  #  #  #     #  #
####  #  ####  ####  #######  ####  ##########  #  #######  #  ####  #######  #######  ####  ####  ####  #  #  ##########  #  ####  #  #  #######  #  #
#           #              #  #  #  #           #        #     #     #                    #           #  #  #  #        #     #  #        #           #
#######  #######  #############  ####  #######  ####  #  #  #  #  #  #  ####  ####  #######  #  ####  #  #  ####  #  #######  #  #######  #######  ####
#  #        #     #     #     #        #     #  #  #  #  #  #  #  #     #  #     #        #  #     #     #  #     #  #  #     #        #  #           #
#  ####  #  ####  ####  #  ##########  ####  ####  #  #######  #  #  ####  #  ###################  #######  ####  #  #  ##########  ####  ####  ####  #
#  #  #  #  #  #     #           #        #     #     #        #  #  #  #     #              #     #  #           #  #           #     #  #     #     #
#  #  ####  #  #  #############  ####  ####  ##########  #######  ####  #######  ####  #############  #  ######################  ####  #  ####  #######
#           #     #  #           #     #     #        #     #                    #  #  #  #     #           #              #        #  #     #        #
####  #  ####  ####  #######  #  ##########  ####  #  #  ######################  #  #  #  #  #  ####  #######  ##########  #######  #  ####  #######  #
#  #  #  #  #        #     #  #     #  #           #           #  #                 #        #     #        #  #     #              #     #           #
#  ####  #  ####  ####  #  #######  #  ################  #######  ###################  ##########  #######  #  ####  ##########  #  ####  #  #######  #
#  #     #              #  #  #  #        #  #     #        #     #     #  #  #     #  #     #     #  #  #     #     #        #  #  #              #  #
#  ################  #  ####  #  ####  ####  ####  ####  ####  #######  #  #  #  ####  ####  ####  #  #  #  #  #  #######  #  #######  #######  #  ####
#                    #  #        #  #  #     #  #  #  #        #           #  #     #  #  #  #  #           #        #     #     #  #  #  #     #  #  #
#  #############  #######  ####  #  #  #  #  #  #  #  #  ##########  #  #  #  #  ####  #  #  #  #  #############  ##########  ####  ####  #  #######  #
#     #  #  #        #     #           #  #           #  #  #  #  #  #  #  #     #     #              #     #        #           #     #           #  #
####  #  #  ####  #######  ################  #  #  ####  #  #  #  ####  ####  #  #  ##########  ####  #  #  #  #######  ####  #  #  #  ####  #  ####  #
#  #  #           #  #                 #     #  #                 #        #  #  #  #  #        #  #  #  #  #              #  #  #  #     #  #  #  #  #
#  #######  #  ####  ################  #  ####  ####  ####  #######  ##########  #  #  ##########  #######  #######  #######  #######  ####  ####  #  #
#  #        #     #        #           #     #     #     #     #  #  #        #  #           #              #     #  #  #     #        #              #
#  ##########  #######  ####  #############  #  ################  #  #  #######  #  #######  #  ##########  #  ####  #  #######  #  ####  ##########  #
#        #        #  #  #  #                 #  #     #        #     #  #        #     #  #        #     #  #     #        #  #  #  #        #  #     #
#######  #  #  #  #  #  #  ####  #  ####  #######  ##########  ####  #  #  #######  ####  #######  #  #######  #  ##########  #  #  #  #  ####  #  #  #
#           #  #           #     #  #     #                                                     #  #           #                 #     #  #        #B #
#######################################################################################################################################################