#######################################################################################################################################################
#A   #                       #                          #        #           #        #           #  #     #     #                 #           #      #
#  ####  #  #  ################  ##########  ##########  #  ####  #######  #  ####  #  #  #  ####  #  #  #  #  #  #  #  ##########  #  #######  #  #  #
#        #  #  #           #        #     #     #     #     #              #        #  #  #     #  #     #     #  #  #  #        #     #        #  #  #
#  #######  #  #  #######  #  #######  #  ####  #  #  #######  ######################  #######  #  #  ##########  #  #  #######  #######  #######  #  #
#  #  #     #  #  #     #     #     #  #        #  #  #           #     #           #  #     #  #  #  #     #     #  #        #  #        #        #  #
#  #  #  #  ####  #  ##########  #  #  ####  ####  #  #  ##########  #  #  #######  #  #  #  #  #  ####  #  #  #  #  #######  #  #  #######  #######  #
#     #  #  #     #        #     #     #     #     #  #  #           #  #     #     #  #  #     #        #     #  #        #  #     #        #        #
####  #  ####  #######  ####  ################  ####  ####  ##########  #  #  #######  #  ####  ################  #######  #  #######  #######  #######
#     #     #  #     #  #     #                 #  #           #        #  #  #           #     #           #     #     #  #           #     #        #
##########  #  #  #  #  #  #  #  ################  #############  ##########  #  ################  #######  ####  ####  #  #############  #  #######  #
#           #     #     #  #  #  #                    #           #        #  #  #           #     #     #     #        #     #     #     #        #  #
#  ####  #############  #  ####  #  #######  ####  ####  ##########  ####  #  #  #  #######  #  ####  #  ####  #############  ####  #  ##########  #  #
#     #  #        #     #        #  #        #  #  #     #           #  #  #     #  #     #     #  #  #        #              #     #     #        #  #
#  #  ####  ####  #  ################  #######  #  #  #  #  ##########  #  #######  #  #  #######  #  #######  #  #############  #######  ####  ####  #
#  #     #     #     #                 #        #  #  #  #     #        #  #        #  #  #        #     #     #  #              #     #     #  #     #
#######  ####  ###################  #######  #  #  #  #######  #  #  ####  #  ##########  #  #  #  ####  #######  ####  ##########  #  ####  #  ####  #
#        #     #           #        #        #  #  #        #     #  #     #  #        #     #  #     #                 #           #     #  #     #  #
#  #######  #######  ####  #  #######  #  #######  ####  ##########  #  #  #  #  ####  #######  #############  ##########  #############  #  ####  #  #
#  #     #  #        #     #  #        #           #  #              #  #  #  #  #              #           #  #        #  #        #        #     #  #
#  #  #  #  ####  ####  ####  #  ###################  ################  ####  #  #  ##########  #  #######  #  #  ####  #  #  ####  ##########  ####  #
#     #  #  #     #  #        #              #     #        #           #     #  #     #     #  #     #     #  #     #     #  #  #     #     #     #  #
#  ####  #  #  ####  ######################  #  #  #  ####  #  #######  #  ####  ####  #  #  #  ####  #  ##########  #######  #  ####  #  #######  #  #
#  #  #     #     #  #           #     #  #  #  #     #  #  #  #        #  #        #  #  #  #     #  #        #     #        #  #     #        #     #
#  #  ##########  #  #  ####  #  #  #  #  #  #  #######  #  #  ##########  #######  ####  #  #######  #######  #  #  #  #######  #  #######  #######  #
#     #           #     #     #     #     #  #  #           #           #        #  #     #        #        #     #  #  #     #  #        #           #
####  #  ##########  ####  ################  #  #  ###################  #######  #  #  ##########  #######  ##########  #  #  #  #######  #  ##########
#     #     #     #     #              #     #  #  #     #           #     #     #  #  #        #           #           #  #        #     #  #        #
#  ####  #  ####  ####  #############  #  ####  #  #  #  #  #######  #  ####  ####  #  #######  ##########  #  ##########  #######  #  ####  #  #  ####
#  #     #  #     #     #           #           #  #  #     #     #  #        #     #  #        #           #  #           #     #  #  #     #  #     #
#  #######  #  ####  ####  #  ###################  #  #######  ####  #  ##########  #  #  ####  #  ##########  ####  #######  ####  #  #  ##########  #
#  #        #              #  #        #           #  #     #        #     #        #  #  #     #  #        #     #  #        #     #  #              #
#  #  #######  ################  ####  #############  #  #  #  ##########  #  #######  #  #######  #  #  #  ####  #  ####  #  #  ####  #############  #
#  #  #              #        #  #     #              #  #  #  #        #     #     #  #  #     #  #  #  #     #  #     #  #        #  #           #  #
#  #  #############  #  ####  #  ####  #  #############  #  #  #  ####  ####  #  #  #  #  #  #  #  #  #  ####  #  #  #  #######  ####  #  ####  ####  #
#  #  #        #     #  #  #  #     #     #              #  #     #  #  #  #  #  #     #     #     #  #  #     #  #  #        #  #     #     #        #
#  #  #  ####  #######  #  #  ####  ######################  #######  #  #  #  #  ##########  ##########  #  ####  ##########  #  #  ####  ##########  #
#     #     #        #  #  #        #                       #        #  #     #  #        #     #        #     #  #        #  #  #     #  #        #  #
####  ####  #######  #  #  ##########  #  ################  #  #  ####  #######  #  ####  ####  #  #############  #  ####  #  #  ####  ####  ####  #  #
#     #     #     #     #        #     #  #     #           #  #  #     #     #  #  #  #     #  #  #              #  #  #  #  #     #        #  #  #  #
#######  #######  ##########  #  #  #  ####  #  #  ##########  #  #  ####  #  #  #  #  ####  #  #  #  #############  #  #  #  ####  ##########  #  ####
#        #     #     #        #  #  #        #  #        #     #  #        #  #     #     #  #     #  #              #        #  #  #           #     #
#  ####  #  #  #  #  #  #  ####  #  ##########  #  #######  ####  ##########  #  #######  #  #######  ##########  #  ##########  #  #  #######  ####  #
#     #  #  #  #  #     #     #  #  #        #  #  #           #           #  #           #     #           #     #  #        #        #     #     #  #
####  #  #  #  #######  ####  ####  ####  #  #  ####  ##########  #######  #  #######  #######  #  #######  #  ####  #  ####  ##########  #######  #  #
#     #  #  #        #     #              #  #        #     #     #  #     #     #     #     #  #  #     #     #     #     #        #  #        #  #  #
#  #######  #######  ####  ################  #############  #  ####  #  #######  #######  #  #  #  #  #  ################  #######  #  #  ####  #  #  #
#  #     #  #     #  #           #     #  #  #              #  #     #        #     #     #  #  #  #  #                 #  #  #     #        #     #  #
#  #  #  #  #  #  #  #############  #  #  #  ####  ####  ####  #  #  #######  ####  #  ####  #  #  #  ################  #  #  #  #############  ####  #
#     #        #  #  #     #     #  #  #        #  #  #  #     #  #        #     #  #  #  #  #     #     #        #  #     #     #           #  #  #  #
#  #############  #  #  #  #  #  #  #  #######  #  #  #  #  ####  #######  ####  #  #  #  #  #  #######  #  ####  #  #######  #######  ####  #  #  #  #
#  #  #     #  #  #     #     #     #     #     #  #     #  #           #     #  #     #     #        #  #  #     #  #        #     #  #  #  #     #  #
#  #  #  #  #  #######  ################  #  ####  #  ####  #  #######  #  ####  #######  #######  ####  #  #  ####  #  #######  #  #  #  #  #######  #
#     #  #     #     #              #     #  #     #  #     #  #     #  #  #     #     #     #     #     #  #     #  #           #  #  #     #        #
####  #  #######  #  #############  #  ####  #  #  ####  #  ####  #  #  ####  ####  #  ####  #  ####  ####  ####  #  #############  #  #  ####  ####  #
#  #  #  #     #  #        #        #     #     #  #     #  #     #  #     #  #  #  #     #  #     #  #        #     #           #     #  #        #  #
#  #  #  #  #  #  #######  #############  #######  #  #######  ####  #  #  #  #  #  #  ####  #  ####  #  ####  #  ####  ####  #  #######  #######  ####
#  #  #     #     #  #     #           #     #     #        #  #  #  #  #     #     #     #  #  #     #     #  #  #        #  #        #        #     #
#  #  #############  #  ####  #######  #  #  ####  #######  #  #  #  #######  ##########  #  ####  ##########  #  #  #######  ################  #  #  #
#  #  #              #     #     #     #  #     #     #  #  #  #  #        #           #  #        #        #  #  #  #     #     #              #  #  #
#  #  #  #######  #######  #  #  #  ##########  ####  #  #  #  #  #######  ##########  #  ##########  #  #  #  #  #  #  #  ####  #  ################  #
#  #  #     #     #        #  #  #              #     #  #  #     #     #  #        #     #        #  #  #     #  #  #  #  #     #     #     #        #
#  #  #######  #  #  #######  #  ################  ####  #  ####  ####  #  ####  #  ####  ####  #  #  #  ####  ####  #  #  #  #  ####  #  #  #  #  #  #
#              #  #  #        #           #     #        #     #  #     #  #     #     #        #  #  #  #     #     #  #     #     #     #  #  #  #  #
#  #############  #  ###################  #  ##########  #  ####  #  ####  #  ################  ####  #  #######  ####  ##########  #######  ####  ####
#     #        #  #              #        #           #  #           #     #                    #     #           #  #     #              #     #     #
####  #  ####  #  #############  #  #######  #######  #  #############  ####  ###################  ################  ####  ####  #############  ####  #
#     #  #  #  #           #     #  #     #     #  #        #        #  #  #  #        #     #  #     #                 #     #  #           #     #  #
#  ####  #  #  #######  ####  ####  #  #  ####  #  ##########  ####  #  #  #  #  ####  #  #  #  ####  #  #############  ####  ####  #######  ####  #  #
#  #  #  #  #     #     #     #        #  #     #  #        #  #  #     #        #     #  #     #     #     #     #        #     #     #  #     #     #
#  #  #  #  ####  #######  ####  #######  #  ####  #  ####  #  #  #######  ##########  #  #######  #######  #  #  #######  ####  ####  #  #  #######  #
#     #        #        #     #        #  #        #     #     #        #  #        #  #  #        #     #     #     #     #  #  #     #  #  #        #
####  #######  #######  ####  ####  ####  #######  ####  ####  #######  #  #  ####  #  #  #  #######  #  ####  ####  ####  #  #  #  ####  #  #  #######
#  #     #     #     #        #  #  #     #     #     #     #  #     #     #     #  #  #  #  #        #     #     #     #     #     #     #  #  #     #
#  #  ####  ####  #  ##########  #  #  ####  ####  #######  ####  #  ##########  #  #  #  #  #  ##########  ####  ####  ####  #######  ####  #  ####  #
#     #     #     #        #        #  #        #  #     #  #     #           #  #  #     #  #     #  #     #        #  #  #  #     #  #     #     #  #
#######  ####  #######  #  ##########  #  ####  #  #  #  #  #  ##########  ####  #  #######  #  #  #  #  ####  #######  #  #  #  #  #  #  #  ####  #  #
#        #  #        #  #     #        #  #  #     #  #  #  #  #        #  #     #  #        #  #  #  #  #     #        #  #     #  #  #  #     #  #  #
#  #######  #######  #  ####  #  #######  #  #######  #  #  #  ####  #  #  #  ####  #  #######  #  #  #  #  ####  #######  #######  #  #  #  ####  #  #
#  #        #        #  #  #  #     #              #  #     #        #  #  #     #  #     #     #  #  #  #     #  #     #        #  #  #  #  #     #  #
#  ####  #  #  #######  #  #  ####  ################  ################  #  ####  #  ####  #######  #  #  ####  #  #  #  #  #  ####  #  #  ####  ####  #
#     #  #     #        #  #     #        #     #     #     #        #  #        #     #  #        #  #  #     #  #  #  #  #     #     #        #     #
####  #######  #  #######  ####  #######  #  #  #  ####  #  #  ####  #  ##########  #  #  #  #######  #  #  ####  #  #  #  ####  ####  ##########  ####
#  #        #  #  #        #     #        #  #     #     #  #     #     #           #  #     #  #        #  #     #  #     #        #  #        #     #
#  #######  ####  #######  #  ####  #######  #  ####  ####  #  ##########  ###################  #  ##########  ####  #######  ####  #  #  #  ####  #  #
#  #     #     #  #        #  #        #     #  #     #  #     #           #                 #     #     #     #  #  #     #     #  #  #  #        #  #
#  #  #  ####  #  #  #######  #######  #  #  ####  ####  #######  ##########  #############  #  ####  #  #  ####  #  #  #  ####  ####  #  ##########  #
#     #     #  #  #        #        #  #  #        #  #        #           #  #  #        #     #     #     #        #  #     #  #     #  #        #  #
#  #######  #  #  #  ####  #######  #  ####  #######  #  ####  ##########  #  #  #  ####  ##########  #######  #######  ####  #  #  ####  #  #######  #
#        #  #     #  #     #     #  #     #     #        #           #     #  #        #        #     #  #           #  #        #  #  #  #     #     #
####  ####  #######  #  #  ####  #  ####  ####  #  #######  #######  #  ####  #############  #  #  ####  #  ##########  #  #######  #  #  ####  #  ####
#  #  #           #  #  #        #        #  #  #  #     #  #     #  #     #                 #  #  #     #     #     #  #     #     #           #     #
#  #  #  #######  #  #  ###################  #  ####  #  #  #  #  #  ####  ###################  #  #  #  ####  #  #  #  #######  ###################  #
#     #  #        #  #  #                 #  #        #     #  #  #     #           #        #     #  #     #  #  #     #     #  #        #           #
#  ####  #######  #  #  #  #######  ####  #  ################  #  ####  ####  ####  #  ####  #############  #  #  ####  #  #  #  #  ####  #  #######  #
#  #  #  #     #  #  #  #  #     #     #              #     #  #        #  #     #  #  #     #              #  #     #  #  #     #     #  #     #  #  #
#  #  #  #  #  ####  #  #  ####  ####  #  #######  ####  #  #  ##########  ####  ####  #  #  #  #  #######  #  ####  ####  ##########  #  ####  #  #  #
#  #  #     #  #     #  #     #     #  #  #     #  #     #  #              #  #     #  #  #     #  #     #  #  #  #  #     #           #     #  #  #  #
#  #  #######  #  ####  ####  #  #  #  ####  #  ####  ####  #############  #  ####  #  #  ##########  #  ####  #  #  #  ##########  #######  #  #  #  #
#           #        #           #  #        #           #                       #     #              #           #                 #           #   B #
#######################################################################################################################################################