#######################################################
#A         #              #                    #      #
#  #######  ##########  #  #  #  ##########  ####  #  #
#  #     #              #  #  #     #        #     #  #
#  #  #  ################  #######  ##########  ####  #
#  #  #        #                    #     #     #     #
#  #######  #  #  ################  #  #  #  ####  ####
#        #  #     #        #        #  #     #  #     #
#######  ##########  ####  ##########  #######  ####  #
#     #  #           #  #           #           #     #
#  #  #  #  ##########  ##########  ##########  #  #  #
#  #     #        #              #           #  #  #  #
#  #############  #  #  #######  ##########  #  #  ####
#           #  #  #  #        #  #        #     #     #
#######  #  #  #  ##########  #  #######  ##########  #
#        #  #  #     #     #  #  #     #     #     #  #
#  #######  #  ####  #  #  #  #  #  #  ####  #  #  #  #
#  #     #        #     #  #  #  #  #  #     #  #  #  #
#  #  #  #######  #######  #  #  #  #  #  #  #  #  #  #
#  #  #  #        #     #     #     #     #  #  #     #
#  #  #  ##########  #  #  ################  #  ####  #
#  #  #              #     #        #        #     #  #
#  #  #######  #############  ####  #  ##########  ####
#     #     #     #           #     #  #     #  #     #
#  ####  #  #######  ##########  ####  #  #  #  ####  #
#     #  #        #  #  #        #  #     #        #  #
#######  #######  #  #  #  #######  #######  #######  #
#        #        #  #     #           #     #        #
#  #############  #  ####  ####  #  ####  ####  ####  #
#              #  #     #  #     #  #     #  #     #  #
#  ##########  #  ####  #  #  ####  #  ####  ####  ####
#  #  #        #  #     #  #     #  #           #     #
#  #  #  #######  #  ####  ####  ##########  #######  #
#  #  #  #           #     #     #           #     #  #
#  #  #  #############  ####  #  #  ##########  #  #  #
#     #           #        #  #  #           #  #  #  #
####  ##########  #######  #  #############  #  #  #  #
#  #  #        #     #     #              #  #  #     #
#  #  #  ##########  #  #######  #######  #  #  ####  #
#     #  #           #  #     #  #     #     #     #  #
#  ####  #  ##########  #  #  ####  #  ##########  ####
#  #     #  #     #  #  #  #     #  #           #     #
#  ####  #  #  #  #  #  #  ####  #  ##########  ####  #
#     #  #  #  #  #  #  #  #  #     #           #     #
####  #  #  #  #  #  #  #  #  #######  ##########  ####
#     #  #     #  #  #     #        #     #           #
#  ####  #######  #  #######  ##########  ##########  #
#  #           #  #     #        #     #        #     #
#  #######  #  #  #  ####  ####  #  #  #######  #  ####
#           #  #  #     #     #     #  #        #     #
################  #  #  ####  #######  #  #######  #  #
#     #  #        #  #     #     #  #  #  #     #  #  #
#  #  #  #  #######  #  #######  #  #  #  ####  #  #  #
#  #     #        #  #           #  #  #     #     #  #
#  #######  ####  #  #############  #  ####  #  ####  #
#        #     #  #     #     #     #  #     #     #  #
#######  ####  #  ####  #  #  #  #  #  #  ##########  #
#        #     #     #     #     #  #  #  #        #  #
#  #######  #######  #######  #######  #  #  ####  #  #
#  #              #        #  #        #     #  #     #
#  #############  #######  ####  #############  ####  #
#        #     #        #  #     #        #        #  #
#######  #  #  ####  ####  #  ####  ####  #  #  ####  #
#  #     #  #        #     #     #     #     #        #
#  #  ####  ##########  ####  #  ####  ################
#  #     #  #           #     #     #     #           #
#  ####  ####  ##########  #######  ####  ##########  #
#        #     #           #        #     #           #
#  #######  ####  ##########  #######  ####  #######  #
#           #              #                 #      B #
#######################################################